---------------------------------
|   | * |   |   |   | * | * | * |
|   | * |   | * |   |   |   |   |
|   | * |   | * |   | * | * | * |
|   | * |   | * | * | * | * | * |
|   |   |   | * |   |   |   | * |
| * | * |   | * |   | * |   |   |
|   | * |   | * |   | * |   | * |
|   |   |   |   |   | * | / | * |
---------------------------------